NO ./assets/wallpaper_torn_sale.xpm
SO ./assets/wall_red_wood.xpm
WE ./assets/abimee.xpm
EA ./assets/red_wall_paint_happy_women.xpm
C 80,80,80
F 142,123,164

111111111   111111
100001001  1000001
100001001111000001
10000100000000001
1000010011111111
10000101        
10000001111111111
10000100000000001
10000100000000001
10000100000000001
11111110000000001
     100000000001
11111000000000001111111
    110000100000000001
      10000100000000001
      10N00001111000001
      10000100001111101
      10111100001   101
      10000100001111101
      10000000000000001
      11111111111111111