1111111111111111111111111111111111111111
1N00000000000000000000000000000000000001
1111111111111111111111111111111111111111
