111111111111111111111111
100000000000N00000000001
100000000000000000000001
100000000000000000000001
100000000000010000000001
100000000000100100001001
110000100001110000100001
100000000000111110000001
100000000000100000000001
101000000000100000001001
100000000000100010000001
100000000000100000000001
100000100000000000001001
100000010000000000000001
111111111111111111111111
