11111111
11111111
11000011
11000011
11000011
11000011
11000011
11000011
11000011
1100N011
11111111
11111111
