11111111
11111111
1100N011
11000011
11111111
11111111
