11111111
11111111
11000011
11000011
11000011
110N0011
11000011
11000011
11000011
11000011
11111111
11111111
