11111111111111111111111111111
10000000000000000000100000001
10010001000000000000100000001
10000000000000000000100000001
10N00001000000000000111111111
10000000000000000000000000001
11111111110001111111000011111
10000000000000000000000000001
10000000000000000000000000001
11111111111111111111111111111
