111111110
111111111
110000112
1100N0113
111111114
111111115
01234567
