NO ./assets/wall_red_wood.xpm
SO ./assets/griffure.xpm
WE ./assets/wallpaper_torn_sale.xpm
EA ./assets/red_wall_paint_happy_women.xpm
F ./assets/smiley.xpm
C ./assets/smiley.xpm

c ./assets/door
o ./assets/smiley.xpm
t ./assets/smiley.xpm
S_t ./assets/cobble.xpm
W_t ./assets/chatmignon.xpm
F_F ./assets/smiley.xpm

MAP
1111111111111111111111111
1000000000110000000000001
1011000001110000000000001
100100000000000000000000111111111
111111111011000001110000000000001
10000000001100000111011111t111111
11110111111111011100000010001
11110111111111011101c10000001
110000001101010111000000o0001
10000000000000011000000110t01
1000000000000000110101001000t
11000001110101011111011110N0111
11110111 1110101 101111010001
11111111 1111111 111111111111
