NO ./assets/smiley.xpm
SO ./assets/smiley.xpm
WE ./assets/smiley.xpm
EA ./assets/smiley.xpm
F ./assets/smiley.xpm
C ./assets/smiley.xpm

c ./assets/smiley.xpm
o ./assets/smiley.xpm
t ./assets/smiley.xpm
S_t ./assets/cobble.xpm
W_t ./assets/chatmignon.xpm
F_F ./assets/smiley.xpm

MAP
1111111111111111111111111
1000000000110000000000001
1011000001110000000000001
100100000000000000000000111111111
111111111011000001110000000000001
10000000001100000111011111t111111
11110111111111011100000010001
11110111111111011101010000001
110000001101010111000000t0001
10000000000000011000000110101
10000000000000001101010010001
1100000111010101111101111000111
11110111 1110101 101111010N01
11111111 1111111 111111111111
