NO ./assets/abimee.xpm
SO ./assets/wall_red_wood.xpm
WE ./assets/red_wall_paint_happy_women.xpm
EA ./assets/wallpaper_torn_sale.xpm
F ./assets/floor_wood_plank.xpm
C ./assets/floor_wood_plank.xpm

OW_f ./assets/chatmignon.xpm
OE_j ./assets/chandelier.xpm
C_j ./assets/floor_light.xpm
F_j ./assets/floor_light.xpm
D_i ./assets/door.xpm
c ./assets/griffure.xpm
o ./assets/griffure.xpm

MAP
1111111111111c1111111111111
1000000i0000000001000000001
1000000c000j00000i00000000c
100000010000000001000000001
11111111111i111c11111i11111
1111c0000000000001000000001
11i11000000N00f00i000000001
1000i000000000000c00000000c
110110000000000001000000001
11i10111i11c1111111111111i1
10000001000000000i000000001
1000000c0000000001000000001
1000000i000000000c000000001
111111111111111111111111111
