NO ./assets/smiley.xpm
SO ./assets/smiley.xpm
WE ./assets/smiley.xpm
EA ./assets/smiley.xpm
F ./assets/smiley.xpm
C ./assets/smiley.xpm

D_d_y ./assets/door.xpm ./assets/door.xpm
MR_y ./assets/sounds/laugh.wav ./assets/sounds/scream.wav
OW_t ./assets/cobble.xpm

MAP
111111111111111111111111111
100000010000000001000000001
100000000000000001000000001
100000010000000001000000001
100000010000000001000000001
100000000000000001000000001
100000010000000001000000001
100000010000000001000000001
100000000000100001000000001
100000010000y00001000000001
100000000000100010000000001
100000010000N00001000000001
100000010000000001000000001
100000010000000001000000001
100000000000000001000000001
100000010000000001000000001
111111111111111111111111111