NO ./assets/smiley.xpm
SO ./assets/smiley.xpm
WE ./assets/smiley.xpm
EA ./assets/smiley.xpm
F ./assets/smiley.xpm
C ./assets/smiley.xpm

MAP
            1
111111111111111111111111111
100000010000000001000000001
100000000000W00001000000001
100000010000000001000000001
111111111111111111111111111
            1