NO ./assets/smiley.xpm
SO ./assets/smiley.xpm
WE ./assets/smiley.xpm
EA ./assets/smiley.xpm
F ./assets/smiley.xpm
C ./assets/smiley.xpm

c ./assets/smiley.xpm
o ./assets/smiley.xpm

MAP
111111111111111111
1111c0000000000001
11c11000000000001
10000110000N000001
11c10c100000000001
111101100000000001
100000000000000001
100000000000000001
100000000000000001
111111111111111111
