NO ./assets/smiley.xpm
SO ./assets/smiley.xpm
WE ./assets/smiley.xpm
EA ./assets/smiley.xpm
F ./assets/smiley.xpm
C ./assets/smiley.xpm

c ./assets/door.xpm
o ./assets/door.xpm

MAP
111111111111111111111111111
1111c0000000000001000000001
11c11000000N000001000000001
10000110000000000c000000001
11c100c00000000001000000001
11110111111c111111111111111
100000010000000001000000001
1000000c0000000001000000001
100000010000000001000000001
111111111111111111111111111
