NO ./assets/smiley.xpm
SO ./assets/smiley.xpm
WE ./assets/smiley.xpm
EA ./assets/smiley.xpm
F ./assets/smiley.xpm
C ./assets/smiley.xpm

c ./assets/cobble.xpm
o ./assets/cobble.xpm

MAP
111111111111111111
100000000100000001
10S000000c00000001
100000000100000001
100011c11111c00001
100000000100000001
10000000c000000001
100000000c00000001
100000000000000001
111111111111111111
