NO ./assets/xpm/test/wall_red_wood.xpm
SO ./assets/xpm/test/wall_red_wood.xpm
WE ./assets/xpm/test/wall_red_wood.xpm
EA ./assets/xpm/test/wall_red_wood.xpm
F ./assets/xpm/test/floor_wood_plank.xpm
C ./assets/xpm/ceiling.xpm

H_E ./assets/sounds/narrator/1-start.wav ./assets/sounds/subtitle/1-start.txt

T_F ./assets/exit
HR_F ./assets/sounds/narrator/15-closed_exit.wav ./assets/sounds/subtitle/15-closed_exit.txt ./assets/sounds/narrator/35-end.wav ./assets/sounds/subtitle/35-end.txt

! ./assets/enfance/chambre/wall_chambre_sombre.xpm
F_" ./assets/enfance/chambre/white_wood1.xpm
C_" ./assets/enfance/chambre/e2_ceiling.xpm
OW_# ./assets/enfance/chambre/lit.xpm
F_# ./assets/enfance/chambre/white_wood1.xpm
C_# ./assets/enfance/chambre/e2_ceiling.xpm
OI_$ ./assets/enfance/chambre/book.xpm ./assets/enfance/chambre/livre.xpm ./assets/enfance/chambre/rocking_chair.xpm ./assets/enfance/chambre/rocking_chair_anim
F_$ ./assets/enfance/chambre/white_wood1.xpm
C_$ ./assets/enfance/chambre/e2_ceiling.xpm
H_$ ./assets/sounds/narrator/13-chair.wav ./assets/sounds/subtitle/13-chair.txt
{ ./assets/enfance/chambre/wall_chambre_sombre_window.xpm
OI_% ./assets/bureau/e3/palette_blue.xpm ./assets/bureau/e3/palette_item_blue.xpm
F_% ./assets/enfance/chambre/draw.xpm
C_% ./assets/enfance/chambre/e2_ceiling.xpm

N_& ./assets/enfance/chambre/wall_chambre_sombre.xpm
S_& ./assets/enfance/salle_de_jeu/e1_wall2.xpm
E_' ./assets/enfance/chambre/wall_chambre_sombre.xpm

( ./assets/enfance/salle_de_jeu/e1_wall2.xpm
N_) ./assets/enfance/salle_de_jeu/e1_wall2.xpm
R_*_+ ./assets/enfance/salle_de_jeu/table_diner.xpm ./assets/enfance/salle_de_jeu/table_peluche.xpm
HR_+ ./assets/sounds/narrator/6-bear_toy_table_missing.wav ./assets/sounds/subtitle/6-bear_toy_table_missing.txt ./assets/sounds/narrator/9-bear_toy_table_fill.wav ./assets/sounds/subtitle/9-bear_toy_table_fill.txt
C_+ ./assets/enfance/salle_de_jeu/e1_ceiling/nuage1.xpm
F_+ ./assets/enfance/salle_de_jeu/e1_floor.xpm
OI_, ./assets/enfance/salle_de_jeu/ballerina_little ./assets/enfance/salle_de_jeu/ballerina_hand ./assets/enfance/salle_de_jeu/furniture_full ./assets/enfance/salle_de_jeu/furniture_empty.xpm
H_, ./assets/sounds/narrator/5-music_box.wav ./assets/sounds/subtitle/5-music_box.txt
MO_, ./assets/sounds/childhood/e1/music_box.wav
C_, ./assets/enfance/salle_de_jeu/e1_ceiling/nuage2.xpm
F_, ./assets/enfance/salle_de_jeu/e1_floor.xpm
OI_u ./assets/doors/key_black.xpm ./assets/doors/key_black_item.xpm ./assets/enfance/salle_de_jeu/meuble.xpm ./assets/enfance/salle_de_jeu/meuble.xpm
C_u ./assets/enfance/salle_de_jeu/e1_ceiling/nuage3.xpm
F_u ./assets/enfance/salle_de_jeu/e2_floor.xpm
C_- ./assets/enfance/salle_de_jeu/e1_ceiling
F_- ./assets/enfance/salle_de_jeu/e1_floor.xpm
F_. ./assets/enfance/salle_de_jeu/e2_floor.xpm
C_. ./assets/enfance/salle_de_jeu/e1_ceiling

/ ./assets/enfance/salon/chimney/
OI_2 ./assets/enfance/salon/collier_floor.xpm ./assets/enfance/salon/collier.xpm ./assets/enfance/salon/commode.xpm ./assets/enfance/salon/commode_empty.xpm
H_2 ./assets/sounds/narrator/17-necklace.wav ./assets/sounds/subtitle/17-necklace.txt
OI_3 ./assets/enfance/salon/lettre.xpm ./assets/enfance/salon/lettre_item.xpm ./assets/enfance/salon/armoir.xpm ./assets/enfance/salon/armoir_empty.xpm
MO_3 ./assets/sounds/childhood/e3/paper.wav
H_3 ./assets/sounds/narrator/18-letter.wav ./assets/sounds/subtitle/18-letter.txt
F_4 ./assets/enfance/salon/chimney_floor/
M_4 ./assets/sounds/childhood/e3/fireplace.wav

5 ./assets/bureau/e1/wall_bureau
S_6 ./assets/bureau/e1/wall_bureau/wall.xpm
C_7 ./assets/bureau/e1/ceiling.xpm
F_7 ./assets/bureau/e1/floor.xpm
OI_s ./assets/doors/key_blue.xpm ./assets/doors/key_blue_item.xpm ./assets/bureau/e1/armoir_tiroir.xpm ./assets/bureau/e1/armoir_tiroir.xpm
C_s ./assets/bureau/e1/ceiling.xpm
F_s ./assets/bureau/e1/floor.xpm
OI_8 ./assets/bureau/e1/lettre_demission.xpm ./assets/bureau/e1/lettre_demission_item.xpm ./assets/bureau/e1/bureau_letter ./assets/bureau/e1/bureau_empty
M_8 ./assets/sounds/office/e2/paper_crumpling.wav
H_8 ./assets/sounds/narrator/10-office_desk_take.wav ./assets/sounds/subtitle/10-office_desk_take.txt
C_8 ./assets/bureau/e1/ceiling.xpm
F_8 ./assets/bureau/e1/floor.xpm
R_8_9 ./assets/bureau/e1/poubelle_empty.xpm ./assets/bureau/e1/poubelle.xpm
HR_9 ./assets/sounds/void.wav ./assets/sounds/subtitle/void.txt ./assets/sounds/narrator/11-trash_take.wav ./assets/sounds/subtitle/11-trash_take.txt
C_9 ./assets/bureau/e1/ceiling.xpm
F_9 ./assets/bureau/e1/floor.xpm
OI_* ./assets/bureau/e1/peluche.xpm ./assets/bureau/e1/peluche_item.xpm
C_* ./assets/bureau/e1/ceiling.xpm
F_* ./assets/bureau/e1/floor.xpm
H_* ./assets/sounds/narrator/8-teddybear.wav ./assets/sounds/subtitle/8-teddybear.txt

OI_: ./assets/bureau/e1/lettre_demission.xpm ./assets/bureau/e1/lettre_demission_item.xpm ./assets/bureau/e1/poubelle.xpm ./assets/bureau/e1/poubelle_empty.xpm
C_: ./assets/bureau/e1/ceiling.xpm
F_: ./assets/bureau/e1/floor.xpm
M_: ./assets/sounds/office/e2/paper_crumpling.wav
H_: ./assets/sounds/narrator/20-trash_take.wav ./assets/sounds/subtitle/20-trash_take.txt
OW_; ./assets/bureau/e1/bureau_empty
C_; ./assets/bureau/e1/ceiling.xpm
F_; ./assets/bureau/e1/floor.xpm

< ./assets/bureau/e2/wall
= ./assets/bureau/e2/window_boss1.xpm
> ./assets/bureau/e2/window_boss2.xpm
? ./assets/bureau/e2/window_boss3.xpm
F_@ ./assets/bureau/e2/floor_boss.xpm
C_@ ./assets/bureau/e2/ceiling_boss_left.xpm
F_A ./assets/bureau/e2/floor_boss.xpm
C_A ./assets/bureau/e2/ceiling_boss.xpm
F_B ./assets/bureau/e2/floor_boss.xpm
C_B ./assets/bureau/e2/ceiling_boss_right.xpm
R_:_C ./assets/bureau/e2/bureau_boss.xpm ./assets/bureau/e2/bureau_boss_letter.xpm
C_C ./assets/bureau/e2/ceiling_boss.xpm
F_C ./assets/bureau/e2/floor_boss.xpm
HR_C ./assets/sounds/void.wav ./assets/sounds/subtitle/void.txt ./assets/sounds/narrator/21-boss_give_letter.wav ./assets/sounds/subtitle/21-boss_give_letter.txt
OI_D ./assets/bureau/e2/masse.xpm ./assets/bureau/e2/masse_item.xpm
F_D ./assets/bureau/e2/floor_boss.xpm
C_D ./assets/bureau/e2/ceiling_boss.xpm
R_D_O ./assets/bureau/e2/statue_gauche.xpm ./assets/bureau/e2/statue_destroy.xpm
C_O ./assets/bureau/e2/ceiling_boss_left.xpm
F_O ./assets/bureau/e2/floor_boss.xpm
MR_O ./assets/sounds/void.wav ./assets/sounds/office/e2/statue.wav
HR_O ./assets/sounds/void.wav ./assets/sounds/subtitle/void.txt ./assets/sounds/narrator/22-crush_statue.wav ./assets/sounds/subtitle/22-crush_statue.txt
OI_M ./assets/bureau/e2/star.xpm ./assets/bureau/e2/star_item.xpm ./assets/bureau/e2/statue_star.xpm ./assets/bureau/e2/statue_droite.xpm
F_M ./assets/bureau/e2/floor_boss.xpm
C_M ./assets/bureau/e2/ceiling_boss_right.xpm
H_M ./assets/sounds/narrator/23-star_statue.wav ./assets/sounds/subtitle/23-star_statue.txt

G ./assets/bureau/e3/wall
F_H ./assets/bureau/e3/floor.xpm
C_H ./assets/bureau/e3/ceiling.xpm
R_J_I ./assets/bureau/e3/chevalet_in_progress.xpm ./assets/bureau/e3/chevalet.xpm
F_I ./assets/bureau/e3/floor.xpm
C_I ./assets/bureau/e3/ceiling.xpm
MR_I ./assets/sounds/void.wav ./assets/sounds/office/e3/brush.wav
HR_I ./assets/sounds/void.wav ./assets/sounds/subtitle/void.txt ./assets/sounds/narrator/29-finish_painting_beach.wav ./assets/sounds/subtitle/29-finish_painting_beach.txt
R_%_K ./assets/bureau/e3/chevalet1_in_progress.xpm ./assets/bureau/e3/chevalet1.xpm
F_K ./assets/bureau/e3/floor.xpm
C_K ./assets/bureau/e3/ceiling.xpm
HR_K ./assets/sounds/narrator/27-not_finished_painting_beach.wav ./assets/sounds/subtitle/27-not_finish_painting_house.txt  ./assets/sounds/narrator/28-finish_painting_house.wav ./assets/sounds/subtitle/28-finish_painting_house.txt
MR_K ./assets/sounds/void.wav ./assets/sounds/office/e3/brush.wav
OI_J ./assets/bureau/e3/palette_green.xpm ./assets/bureau/e3/palette_item_green.xpm
F_J ./assets/bureau/e3/floor.xpm
C_J ./assets/bureau/e3/ceiling.xpm
OI_L ./assets/bureau/e3/cadeau.xpm ./assets/bureau/e3/cadeau_item.xpm
F_L ./assets/bureau/e3/floor.xpm
C_L ./assets/bureau/e3/ceiling.xpm

P ./assets/noel/e1/wall1.xpm
F_Q ./assets/noel/e1/floor.xpm
C_Q ./assets/noel/e1/ceiling.xpm
R_M_R ./assets/noel/e1/sapin_moche.xpm ./assets/noel/e1/sapin_moche_etoile.xpm
F_R ./assets/noel/e1/floor.xpm
C_R ./assets/noel/e1/ceiling.xpm
OI_T ./assets/noel/e1/video_floor ./assets/noel/e1/video_hand ./assets/noel/e1/table ./assets/noel/e1/table_no_video.xpm
F_T ./assets/noel/e1/floor.xpm
C_T ./assets/noel/e1/ceiling.xpm
H_T ./assets/sounds/narrator/25-ipad.wav ./assets/sounds/subtitle/25-ipad.txt
R_L_U ./assets/noel/e2/sapin.xpm ./assets/noel/e2/sapin_full.xpm
F_U ./assets/noel/e1/floor.xpm
C_U ./assets/noel/e1/ceiling.xpm
HR_U ./assets/sounds/void.wav ./assets/sounds/subtitle/void.txt ./assets/sounds/narrator/32-gift_take.wav ./assets/sounds/subtitle/32-gift_take.txt
R_X_V ./assets/noel/e2/table_empty.xpm ./assets/noel/e2/table_bouteille.xpm
F_V ./assets/noel/e1/floor.xpm
C_V ./assets/noel/e1/ceiling.xpm
HR_V ./assets/sounds/narrator/33-empty_glass.wav ./assets/sounds/subtitle/33-empty_glass.txt ./assets/sounds/narrator/34-fill_glass.wav ./assets/sounds/subtitle/34-fill_glass.txt
OW_Y ./assets/noel/e2/table_vin.xpm
F_Y ./assets/noel/e1/floor.xpm
C_Y ./assets/noel/e1/ceiling.xpm
OI_X  ./assets/noel/e2/bouteille.xpm ./assets/noel/e2/bouteille_item.xpm ./assets/noel/e2/table_bouteille.xpm ./assets/noel/e2/table_vin.xpm
F_X ./assets/noel/e1/floor.xpm
C_X ./assets/noel/e1/ceiling.xpm
OI_w ./assets/doors/key_red.xpm ./assets/doors/key_red_item.xpm ./assets/noel/e1/meuble_key.xpm ./assets/noel/e1/meuble.xpm
F_w ./assets/noel/e1/floor.xpm
C_w ./assets/noel/e1/ceiling.xpm

N_Z ./assets/noel/e1/wall1.xpm

D_2_[ ./assets/doors/door_noel_close.xpm ./assets/doors/door_noel.xpm
F_[ ./assets/noel/e1/floor.xpm
C_[ ./assets/noel/e1/ceiling.xpm
HR_[ ./assets/sounds/narrator/30-closed_door_living_room_2.wav ./assets/sounds/subtitle/30-closed_door_living_room_2.txt ./assets/sounds/narrator/31-enter_living_room_2.wav ./assets/sounds/subtitle/31-enter_living_room_2.txt

D_\ ./assets/doors/door_couloir.xpm
M_\ ./assets/sounds/open_door.wav
F_\ ./assets/doors/childhood/floor_entry_e1.xpm
C_\ ./assets/doors/childhood/ceiling_entry_e1.xpm
H_\ ./assets/sounds/narrator/4-opened_child_door.wav ./assets/sounds/subtitle/4-opened_child_door.txt

N_m ./assets/enfance/salle_de_jeu/e1_wall2.xpm
E_m ./assets/doors/childhood/wall_entry_e1_left.xpm

W_n ./assets/doors/childhood/wall_entry_e1_right.xpm
N_n ./assets/enfance/salle_de_jeu/e1_wall2.xpm

D_s_] ./assets/doors/door_room_close.xpm ./assets/doors/door_room.xpm
F_] ./assets/doors/childhood/floor_e1_e2.xpm
C_] ./assets/doors/childhood/ceiling_e1_e2.xpm
HR_] ./assets/sounds/void.wav ./assets/sounds/subtitle/void.txt ./assets/sounds/narrator/12-opened_door_room.wav ./assets/sounds/subtitle/12-opened_door_room.txt
E_^ ./assets/doors/childhood/wall_e1_e2_left.xpm
N_^ ./assets/enfance/chambre/wall_chambre_sombre.xpm
S_^ ./assets/enfance/salle_de_jeu/e1_wall2.xpm
W__ ./assets/doors/childhood/wall_e1_e2_right.xpm

D_` ./assets/doors/door_boss_open.xpm
C_` ./assets/doors/office/ceiling_b2_boss.xpm
F_` ./assets/doors/office/floor_b2_boss.xpm

D_j_v ./assets/doors/door_boss_close.xpm ./assets/doors/door_boss_close.xpm
C_v ./assets/doors/office/ceiling_b2_boss.xpm
F_v ./assets/doors/office/floor_b2_boss.xpm

S_j ./assets/doors/office/wall_b2_boss_left.xpm
E_j ./assets/bureau/e2/wall/wall_boss1.xpm
W_j ./assets/bureau/e1/wall_bureau/wall4.xpm

N_k ./assets/doors/office/wall_b2_boss_right.xpm
E_k ./assets/bureau/e2/wall/wall_boss2.xpm
W_k ./assets/bureau/e1/wall_bureau/wall3.xpm

D_t_a ./assets/doors/door_couloir_close_coeur.xpm ./assets/doors/door_couloir.xpm
F_a ./assets/doors/childhood/floor_e2_e3.xpm
C_a ./assets/doors/childhood/ceiling_e2_e3.xpm
HR_a ./assets/sounds/narrator/14-closed_grandma.wav ./assets/sounds/subtitle/14-closed_grandma.txt ./assets/sounds/narrator/16-opened_door_grandma.wav ./assets/sounds/subtitle/16-opened_door_grandma.txt

S_b ./assets/doors/childhood/wall_e2_e3_right.xpm

N_c ./assets/doors/childhood/wall_e2_e3_left.xpm
E_c ./assets/enfance/chambre/wall_chambre_sombre.xpm

D_y_d ./assets/doors/door_couloir_close_rond.xpm ./assets/doors/door_couloir.xpm
F_d ./assets/doors/noel/floor_entry_n1.xpm
C_d ./assets/doors/noel/ceiling_entry_n1.xpm
HR_d ./assets/sounds/void.wav ./assets/sounds/subtitle/void.txt ./assets/sounds/narrator/24-door_living_room_enter.wav ./assets/sounds/subtitle/24-door_living_room_enter.txt
W_o ./assets/doors/noel/wall_entry_n1_right.xpm
N_o ./assets/noel/e1/wall1.xpm
E_p ./assets/doors/noel/wall_entry_n1_left.xpm
N_p ./assets/noel/e1/wall1.xpm

D_z_e ./assets/doors/door_couloir_close_carre.xpm ./assets/doors/door_couloir.xpm
HR_e ./assets/sounds/narrator/2-closed_manor_door.wav ./assets/sounds/subtitle/2-closed_manor_door.txt ./assets/sounds/narrator/3-opened_manor_door.wav ./assets/sounds/subtitle/3-opened_manor_door.txt
MR_e ./assets/sounds/door_locked.wav ./assets/sounds/open_door.wav

D_f ./assets/doors/door_couloir.xpm
F_f ./assets/doors/office/floor_entry_b1.xpm
C_f ./assets/doors/office/ceiling_entry_b1.xpm
H_f ./assets/sounds/narrator/7-opened_office1_door.wav ./assets/sounds/subtitle/7-opened_office1_door.txt

D_w_g ./assets/doors/door_office_close_red.xpm ./assets/doors/door_office1.xpm
C_g ./assets/doors/office/ceiling_b2_art.xpm
F_g ./assets/doors/office/floor_b2_art.xpm
HR_g ./assets/sounds/void.wav ./assets/sounds/subtitle/void.txt ./assets/sounds/narrator/26-opened_door_art.wav ./assets/sounds/subtitle/26-opened_door_art.txt

S_h ./assets/doors/office/wall_b2_art_left.xpm

N_i ./assets/doors/office/wall_b2_art_right.xpm
W_i ./assets/bureau/e3/wall/wall_art1.xpm

D_u_l ./assets/doors/door_office_close_black.xpm ./assets/doors/door_office1.xpm
C_l ./assets/bureau/e1/ceiling.xpm
F_l ./assets/bureau/e1/floor.xpm
HR_l ./assets/sounds/void.wav ./assets/sounds/subtitle/void.txt ./assets/sounds/narrator/19-opened_office_door.wav ./assets/sounds/subtitle/19-opened_office_door.txt

E_q ./assets/doors/office/wall_entry_b1_right.xpm
S_q ./assets/bureau/e1/wall_bureau/wall2.xpm

W_r ./assets/doors/office/wall_entry_b1_left.xpm
S_r ./assets/bureau/e1/wall_bureau/wall1.xpm

OI_t ./assets/doors/key_heart.xpm ./assets/doors/key_heart_item.xpm
E_x ./assets/xpm/wall_key.xpm
OI_y ./assets/doors/key_round.xpm ./assets/doors/key_round_item.xpm ./assets/doors/key_round_item.xpm ./assets/doors/key_round_item.xpm

OI_z ./assets/doors/key_hanged.xpm ./assets/doors/key_square_item.xpm

MAP
         1111b!!!!PPPPPPP1
         1020a"#${PQQQQUP1
         /400c"""!PQXYVQP1
         1300'%""!PQQQQQP1
         1111&&^]_PP[PPPP1
111111111111(,--.(PQQQQRP1
111111111111(-+-.(PQQTQQP1
110000z00001(...u(PQQQQwP1
110000000001)m\n))ZpdoZZZ1
110000E0000e00000000000tF1
110000000001116qfr11111111
1x0000000001 5597s50100011
1y1111111111 55877v0001011
111111111111 5777*50100011
             555l55<<<<<<1
             55:77jDO@@@?1
        GGGGGh5;77`AAACA>1
        GKHHHg7777kBMBBB=1
        GIJHLi55555<<<<<<1
        GGGGGG