NO ./assets/smiley.xpm
SO ./assets/smiley.xpm
WE ./assets/smiley.xpm
EA ./assets/smiley.xpm
F ./assets/smiley.xpm
C ./assets/smiley.xpm

MAP
111111111111111111
100000000000000001
100000000000000001
100000000000000001
100000111111100001
100000000100000001
100000000000000001
100000000000000001
100000000N00000001
111111111111111111
