NO ./assets/smiley.xpm
SO ./assets/smiley.xpm
WE ./assets/smiley.xpm
EA ./assets/smiley.xpm
F ./assets/smiley.xpm
C ./assets/smiley.xpm

c ./assets/smiley.xpm
o ./assets/smiley.xpm

MAP
111111111111111111
101b10100000000001
100000100000000001
10000010000N000001
100000100000001011
100000100000001011
10000010d000001a11
100000100000001111
1000001000000000011111 11111 11111
1000001000000100000001 10001 10001
111c11111111111111f0101 10101 10101
1111111111111111110001 10001 10001
1111111111111111111111 11111 11111