1111111111111111111111111111111111111111111111111111111111111111111111111111111111111111111111111111
1000000000000000000000000000000010000000000000000000000000000000000100000000000000000000000100000001
1001000100000000000000000000000000000000000000000000000000000000000010000000000000000010000100000001
10N0000000000000000000000000000000000000000000000000000000000000000001000000000000000000000100000001
1000000100000000000000000000000000000010000000000000000000000000000000100000000000000010000111111111
1000000000000000000000000000000000000000000000000000100000000000000000010000000000000000000000000001
1111111111000111111111111111111111111111111000001111111111111111111111111111111111111111111000011111
1000000000000000000000000000000000000000000000000000000000000000000000000000000000000000000000000001
1000000000000000000000000000000000000000000000000000000000000000000000000000000000000000000000000001
1111111111111111111111111111111111111111111111111111111111111111111111111111111111111111111111111111
