NO ./assets/xpm/test/wallpaper_torn_sale.xpm
SO ./assets/xpm/test/wall_red_wood.xpm
WE ./assets/xpm/test/abimee.xpm
EA ./assets/xpm/test/red_wall_paint_happy_women.xpm
C ./assets/xpm/test/ceiling.xpm
F ./assets/xpm/test/floor_wood_plank.xpm

D_d ./assets/doors/door_couloir.xpm
D_k_f ./assets/doors/door_couloir_close_coeur.xpm ./assets/doors/door_couloir.xpm
OI_k ./assets/doors/key_heart.xpm ./assets/doors/key_heart_item.xpm

MAP
11111111111111111
1000010000d000001
10N00d01111000001
1000k1000011111d1
1f111100001   101
10000100001111101
10000d0000f000001
11111111111111111